ALAN CRISTIAN SILVA DE OLIVEIRA	alancristian964@gmail.com
ALBERTO LUIZ SILVA JUNIOR	junioralberto2127@gmail.com
ALEFF BRUNNO LIMA MOTA	aleffbrunno95@gmail.com
ANTONIA LAURA DE LIMA QUEIROZ	laura.fla10@hotmail.com
ANTONIO ELIONARIO NOBERTO DO NASCIMENTO	elionober1@gmail.com
ANTONIO JUSTINO DOS SANTOS	antoniosantosradio@hotmail.com
ANTONIO RAFAEL PINHEIRO DANTAS	rafaelpinheiro.380@gmail.com
BRAULLIO TEIXEIRA SOARES	braulliosoares.bs@gmail.com
BRUNO FELIX DIAS	brunofelix.ml@gmail.com
DANIEL HUMBERTO FELIPE BARBOSA	danielhumbertopkn@gmail.com
DANILO ALVES BARBOSA	dan.black.78.78@gmail.com
DANILO DA SILVA RIBEIRO	daniloribeiro@alu.ufc.br
DAVI OLIVEIRA LOPES	davi.ol2012@gmail.com
ELIANO MACIEL LEITAO	elianomaciell@gmail.com
FRANCISCO RENAN DA SILVA MENEZES	renansilva@alu.ufc.com
FRANCISCO ROBSON DE SOUSA SABINO	frobson787@gmail.com
HENRIQUE SAVIO NOGUEIRA DA SILVA	henriquesaviots@alu.ufc.br
IAGO OLIVEIRA LIMA	iago.oliveira@alu.ufc.br
JAMERSON ALVES AGUIAR DA SILVA	jamersonalsilva14@gmail.com
JOAO VICTOR OLIVEIRA FARIAS	victorfarias.new@alu.ufc.br
MARIA TALITA NOGUEIRA DE SOUZA	talitanoguee16@gmail.com
MATHEUS FERNANDES DO NASCIMENTO DANTAS	matheus_fernandes@alu.ufc.br
PEDRO ATILA DE ABREU CLEMENTE	pedroatila555@gmail.com
PEDRO IGOR PEREIRA DE SOUZA	pedro.igor.pds@gmail.com
RAFAEL VIANA DE SOUSA MENDES	rafaelmendesviana@gmail.com
ROBERT DE ALMEIDA CABRAL	robertcabral@alu.ufc.br
ROMEU CAMURCA RABELO	romeucamurcarabelo@gmail.com
SILMARA KELLY TORRES OLIVEIRA	silmarakelly@alu.ufc.br
